....#....................
#.....#...............##.
................#.......#
.....#..............##...
.#...##...#...........#..
@..#......#.........#...&
...........#...#....#....
..#.#..............##....
....#..#.......#.......#.
..............#.....#....
..................#......
..#......##..............
.....................#...
.....#.....#.............
....##..#................
.#.........#.#...........
...............#.........
.........#......#.......#