......#.........#........
.#..................#..#.
.......#.#..#...##.......
.......#.#.........#....#
........#.#..............
@..............#........&
..........#..............
.....................#...
...#..#....#......#......
#.#.................#....
.........................
.#.......................
..#.....#.............#..
............#....#....#..
...........#..##.........
.#...................#.#.
......#.#................
...........##.#...#.....#