.........................
.........................
.........................
.........................
.....####...............
.....#..#...............
..F..#..#..........W....
#####..#..........#######
......##...............#
.......#.......C.......#
.......#...............#
.......#...............#
.......#...............#
.......#...............#
.......#...............#
.......#...............#
#######################.
.........................
