................#........
.........................
........#.....#..........
...................#...#.
.##.....#...#.......#....
@........#.#..#.........&
....#.....#.......#......
....................###..
.................##......
.............#...........
...#....#.......#....#...
..............#..........
........#.........#......
....#..#...#.#.........#.
..............#..........
........#.#......#....#..
..............#..........
.............#........#..