.............#...........
..##........#.....#......
.....#..................#
...#..........#..........
.##.##...................
@........#...........#..&
..................#.##...
.....................#..#
.......#..........#......
..#.#.........#..........
...................##..#.
....#.................#..
...........#...#.........
.#.#.................####
....#.....#...#....#....#
.........................
....#....................
....................##...