...#..#.#.##.........#...
........##...............
......#.............#....
...#...#.....#...........
......#........#........#
@...##...#...........#..&
..#....#.................
....##...................
#........................
..#......................
...#..#..................
...................#.#...
...................#..#..
.#.....#...........##..#.
..#.#...........#........
#.#....................#.
#...#.................#..
...#.#.##..............#.