.........................
.#............#.........#
.#...#.......#....#...#..
...........#.......#.....
.........................
@.......................&
#.....#...#......#.....#.
........#..........#.....
....#........#..........#
..#......................
..............#.#........
.......#...............#.
............#.#.......#..
........#.##.............
....................#....
......#......#...........
.#.......#...............
.............#.........#.