..........#.#..#.....#.#.
.#................#......
#.....#...#......#.......
....................##...
....................#....
@....#.......#..#.......&
...##...#.....#..........
.........#.........#.#...
.....#...................
.................##.#....
#..#...#..........#......
......#..................
..........#....#.#.......
......#..................
...#.......#.............
....#....................
...................#.....
.#..........#.#.........#