....#...................#
...#...............#....#
...........#.#........#..
..............#.....#....
.........................
@.##......#.............&
.#........#..............
.#....#.....##...#..#....
.#.....##.#..............
....................##...
..#..............#.......
.............#.#...#....#
.###.#...................
......................#.#
...#................#....
.....#...................
....#.#..#............#..
..#....#..............#..