....#.........#.#.......#
..........#............#.
........#.....#..........
....#..........##.......#
#......#...#.......#.....
@...............#..#....&
....#....................
.................#.......
.........................
#....#....#..............
.......#.....#...........
......#..................
.............#.......#...
......#...............#..
..#......................
.........#........#......
..#.....#.#..............
....##...................