.....##..............#...
#...........#............
...............#..#......
#.#.......#.#....#.......
.............#..#..#.....
@##.............#.......&
.........................
.........#..............#
...#......#..............
........#..#......##..#..
#.............#..........
.......#.................
..#..###..#........#.....
.#.............#.........
....#....................
#........................
...............##.....#..
............#............