....#...........#.#....##
..#.........#.......#....
..........#...........#..
.#.............#....##...
.#.......................
@....................#..&
.....#...............#...
...#........#............
.......................#.
.........................
#...........#.#..........
.........................
..#.###........#.........
#..........#.............
.........................
............#............
.....................#...
........##...............