.#...#...................
#..........#........#.#..
.............#..........#
......##.......##........
....#...............#....
@....#.......#..........&
................#...#....
......#................#.
......#..................
.........................
...............#.....#...
..................#......
......#.....#....#.......
#.....#..................
.........................
..................#......
.............#....#..#.#.
...#.................#...