..##................##...
....#....................
.........................
......#.....#............
#...#.#.#......#..#.....#
@......................#&
.##.#...............##...
.#..............#...#....
....#.....#.....#...#....
.....#....#..............
.........#....##.........
.....#............#......
................#.....#..
...................##....
.....##.............#....
........#.......#........
.........#..........#....
.........................