....#..#..#..............
....#.......#..#........#
#.##.....#....#..........
.#....#.......#......#...
#.................#.....#
@........#..#..........#&
...#..#.........#......#.
.........#........#....#.
..#...#...#..............
.............#..#....#...
.......#.................
...............#......#..
.##.#..#................#
.#................#...#..
...........#........#....
.......#.......#....#....
...............#......#.#
....#............#..##...